1,1,1,1,1,1,1,1
1,0,0,0,0,a,p,1
1,0,0,0,1,1,0,1
1,0,r,0,0,0,a,1
1,0,1,1,1,0,0,1
1,0,0,r,0,0,0,1
1,0,0,1,1,0,a,1
1,0,0,1,0,0,0,1
1,0,0,1,0,0,0,1
1,0,0,2,0,0,a,1
1,1,1,1,1,1,1,1
