1,1,1,1,1,1,1,1,1,1,1,1,1,1
1,0,a,0,0,a,0,0,a,0,0,p,0,1
1,0,0,1,1,1,1,1,0,0,0,0,0,1
1,0,a,0,0,a,0,1,1,1,0,1,0,1
1,0,0,0,0,0,0,a,0,1,0,0,0,1
1,2,c,0,a,0,1,0,0,a,0,0,0,1
1,1,1,1,1,1,1,1,1,1,1,1,1,1
